{
  "offsetX" : 12.2,
  "offsetY" : 4.0,
  "chipSizeX" : 24.8,
  "chipSizeY" : 17.2,
  "countX" : 9,
  "countY" : 12,
  "edge" : 5,
  "notch" : 9,
  "notchside" : -90,
  "effective": [
    {"x" : 1, "y": 3, "n" : 1},
    {"x" : 1, "y": 4, "n" : 1},
    {"x" : 1, "y": 5, "n" : 1},
    {"x" : 2, "y": 2, "n" : 1},
    {"x" : 2, "y": 3, "n" : 1},
    {"x" : 2, "y": 4, "n" : 1},
    {"x" : 2, "y": 5, "n" : 1},
    {"x" : 2, "y": 6, "n" : 1},
    {"x" : 3, "y": 2, "n" : 1},
    {"x" : 3, "y": 3, "n" : 1},
    {"x" : 3, "y": 4, "n" : 1},
    {"x" : 3, "y": 5, "n" : 1},
    {"x" : 3, "y": 6, "n" : 1},
    {"x" : 4, "y": 1, "n" : 1},
    {"x" : 4, "y": 2, "n" : 1},
    {"x" : 4, "y": 3, "n" : 1},
    {"x" : 4, "y": 4, "n" : 1},
    {"x" : 4, "y": 5, "n" : 1},
    {"x" : 4, "y": 6, "n" : 1},
    {"x" : 4, "y": 7, "n" : 1},
    {"x" : 5, "y": 1, "n" : 1},
    {"x" : 5, "y": 2, "n" : 1},
    {"x" : 5, "y": 3, "n" : 1},
    {"x" : 5, "y": 4, "n" : 1},
    {"x" : 5, "y": 5, "n" : 1},
    {"x" : 5, "y": 6, "n" : 1},
    {"x" : 5, "y": 7, "n" : 1},
    {"x" : 6, "y": 1, "n" : 1},
    {"x" : 6, "y": 2, "n" : 1},
    {"x" : 6, "y": 3, "n" : 1},
    {"x" : 6, "y": 4, "n" : 1},
    {"x" : 6, "y": 5, "n" : 1},
    {"x" : 6, "y": 6, "n" : 1},
    {"x" : 6, "y": 7, "n" : 1},
    {"x" : 7, "y": 1, "n" : 1},
    {"x" : 7, "y": 2, "n" : 1},
    {"x" : 7, "y": 3, "n" : 1},
    {"x" : 7, "y": 4, "n" : 1},
    {"x" : 7, "y": 5, "n" : 1},
    {"x" : 7, "y": 6, "n" : 1},
    {"x" : 7, "y": 7, "n" : 1},
    {"x" : 8, "y": 2, "n" : 1},
    {"x" : 8, "y": 3, "n" : 1},
    {"x" : 8, "y": 4, "n" : 1},
    {"x" : 8, "y": 5, "n" : 1},
    {"x" : 8, "y": 6, "n" : 1},
    {"x" : 9, "y": 2, "n" : 1},
    {"x" : 9, "y": 3, "n" : 1},
    {"x" : 9, "y": 4, "n" : 1},
    {"x" : 9, "y": 5, "n" : 1},
    {"x" : 9, "y": 6, "n" : 1},
    {"x" : 10, "y": 3, "n" : 1},
    {"x" : 10, "y": 4, "n" : 1},
    {"x" : 10, "y": 5, "n" : 1}
  ]
}
