{
  "offsetX" : 12.2,
  "offsetY" : 4.0,
  "chipSizeX" : 24.8,
  "chipSizeY" : 17.2,
  "countX" : 9,
  "countY" : 15,
  "edge" : 5,
  "notch" : 9,
  "notchside" : -90,
  "effective": {
    "1" : {"y" : 1, "x": 3},
    "2" : {"y" : 1, "x": 4},
    "3" : {"y" : 1, "x": 5},
    "4" : {"y" : 2, "x": 2},
    "5" : {"y" : 2, "x": 3},
    "6" : {"y" : 2, "x": 4},
    "7" : {"y" : 2, "x": 5},
    "8" : {"y" : 2, "x": 6},
    "9" : {"y" : 3, "x": 2},
    "10" : {"y" : 3, "x": 3},
    "11" : {"y" : 3, "x": 4},
    "12" : {"y" : 3, "x": 5},
    "13" : {"y" : 3, "x": 6},
    "14" : {"y" : 4, "x": 7},
    "15" : {"y" : 4, "x": 6},
    "16" : {"y" : 4, "x": 5},
    "17" : {"y" : 4, "x": 4},
    "18" : {"y" : 4, "x": 3},
    "19" : {"y" : 4, "x": 2},
    "20" : {"y" : 4, "x": 1},
    "21" : {"y" : 5, "x": 1},
    "22" : {"y" : 5, "x": 2},
    "23" : {"y" : 5, "x": 3},
    "24" : {"y" : 5, "x": 4},
    "25" : {"y" : 5, "x": 5},
    "26" : {"y" : 5, "x": 6},
    "27" : {"y" : 5, "x": 7},
    "28" : {"y" : 6, "x": 7},
    "29" : {"y" : 6, "x": 6},
    "30" : {"y" : 6, "x": 5},
    "31" : {"y" : 6, "x": 4},
    "32" : {"y" : 6, "x": 3},
    "33" : {"y" : 6, "x": 2},
    "34" : {"y" : 6, "x": 1},
    "35" : {"y" : 7, "x": 1},
    "36" : {"y" : 7, "x": 2},
    "37" : {"y" : 7, "x": 3},
    "38" : {"y" : 7, "x": 4},
    "39" : {"y" : 7, "x": 5},
    "40" : {"y" : 7, "x": 6},
    "41" : {"y" : 7, "x": 7},
    "42" : {"y" : 9, "x": 2},
    "43" : {"y" : 8, "x": 6},
    "44" : {"y" : 8, "x": 5},
    "45" : {"y" : 8, "x": 4},
    "46" : {"y" : 8, "x": 3},
    "47" : {"y" : 8, "x": 2},
    "48" : {"y" : 9, "x": 3},
    "49" : {"y" : 9, "x": 4},
    "50" : {"y" : 9, "x": 5},
    "51" : {"y" : 9, "x": 6},
    "52" : {"y" : 10, "x": 5},
    "53" : {"y" : 10, "x": 4},
    "54" : {"y" : 10, "x": 3}
  }
}
