{
  "offsetX" : 12.2,
  "offsetY" : 4.0,
  "chipSizeX" : 24.8,
  "chipSizeY" : 17.2,
  "countX" : 9,
  "countY" : 12,
  "edge" : 5,
  "notch" : 9,
  "notchside" : -90,
  "effective": [
    {"y" : 1, "x": 3, "n" : 1},
    {"y" : 1, "x": 4, "n" : 2},
    {"y" : 1, "x": 5, "n" : 3},
    {"y" : 2, "x": 2, "n" : 8},
    {"y" : 2, "x": 3, "n" : 7},
    {"y" : 2, "x": 4, "n" : 6},
    {"y" : 2, "x": 5, "n" : 5},
    {"y" : 2, "x": 6, "n" : 4},
    {"y" : 3, "x": 2, "n" : 9},
    {"y" : 3, "x": 3, "n" : 10},
    {"y" : 3, "x": 4, "n" : 11},
    {"y" : 3, "x": 5, "n" : 12},
    {"y" : 3, "x": 6, "n" : 13},
    {"y" : 4, "x": 1, "n" : 20},
    {"y" : 4, "x": 2, "n" : 19},
    {"y" : 4, "x": 3, "n" : 18},
    {"y" : 4, "x": 4, "n" : 17},
    {"y" : 4, "x": 5, "n" : 16},
    {"y" : 4, "x": 6, "n" : 15},
    {"y" : 4, "x": 7, "n" : 14},
    {"y" : 5, "x": 1, "n" : 21},
    {"y" : 5, "x": 2, "n" : 22},
    {"y" : 5, "x": 3, "n" : 23},
    {"y" : 5, "x": 4, "n" : 24},
    {"y" : 5, "x": 5, "n" : 25},
    {"y" : 5, "x": 6, "n" : 26},
    {"y" : 5, "x": 7, "n" : 27},
    {"y" : 6, "x": 1, "n" : 34},
    {"y" : 6, "x": 2, "n" : 33},
    {"y" : 6, "x": 3, "n" : 32},
    {"y" : 6, "x": 4, "n" : 31},
    {"y" : 6, "x": 5, "n" : 30},
    {"y" : 6, "x": 6, "n" : 29},
    {"y" : 6, "x": 7, "n" : 28},
    {"y" : 7, "x": 1, "n" : 35},
    {"y" : 7, "x": 2, "n" : 36},
    {"y" : 7, "x": 3, "n" : 37},
    {"y" : 7, "x": 4, "n" : 38},
    {"y" : 7, "x": 5, "n" : 39},
    {"y" : 7, "x": 6, "n" : 40},
    {"y" : 7, "x": 7, "n" : 41},
    {"y" : 8, "x": 2, "n" : 47},
    {"y" : 8, "x": 3, "n" : 46},
    {"y" : 8, "x": 4, "n" : 45},
    {"y" : 8, "x": 5, "n" : 44},
    {"y" : 8, "x": 6, "n" : 43},
    {"y" : 9, "x": 2, "n" : 42},
    {"y" : 9, "x": 3, "n" : 48},
    {"y" : 9, "x": 4, "n" : 49},
    {"y" : 9, "x": 5, "n" : 50},
    {"y" : 9, "x": 6, "n" : 51},
    {"y" : 10, "x": 3, "n" : 54},
    {"y" : 10, "x": 4, "n" : 53},
    {"y" : 10, "x": 5, "n" : 52}
  ]
}
